//MAP CONVERTED BY dmm2tgm.py THIS HEADER COMMENT PREVENTS RECONVERSION, DO NOT REMOVE
"a" = (
/turf/template_noop,
/area/template_noop)
"b" = (
/obj/effect/map_effect/marker_helper/mapmanip/submap/edge{
	dir = 4
	},
/turf/simulated/wall,
/area/mimeoffice)
"d" = (
/obj/effect/decal/warning_stripes/yellow,
/obj/structure/plasticflaps,
/obj/machinery/navbeacon{
	codes_txt = "delivery;dir=2";
	location = "Mime"
	},
/turf/simulated/floor/plating,
/area/mimeoffice)
"e" = (
/turf/simulated/wall,
/area/mimeoffice)
"f" = (
/obj/effect/map_effect/marker_helper/mapmanip/submap/edge{
	dir = 6
	},
/obj/effect/map_effect/marker_helper/mapmanip/submap/edge{
	dir = 4
	},
/turf/simulated/wall,
/area/mimeoffice)
"g" = (
/obj/machinery/hologram/holopad,
/obj/structure/cable{
	icon_state = "2-8"
	},
/obj/machinery/atmospherics/pipe/simple/hidden/supply,
/obj/machinery/atmospherics/pipe/simple/hidden/scrubbers{
	dir = 6
	},
/obj/effect/landmark/start/clown,
/turf/simulated/floor/plasteel{
	icon_state = "bar"
	},
/area/clownoffice)
"h" = (
/obj/structure/statue/bananium/clown/unique{
	name = "Статуя Великого Кекеги"
	},
/turf/simulated/floor/plasteel{
	icon_state = "bar"
	},
/area/clownoffice)
"i" = (
/obj/machinery/power/apc{
	dir = 4;
	pixel_x = 26
	},
/obj/structure/cable{
	icon_state = "0-8"
	},
/obj/item/flag/mime,
/turf/simulated/floor/plasteel{
	dir = 4;
	icon_state = "tranquillite"
	},
/area/mimeoffice)
"j" = (
/obj/machinery/power/apc{
	dir = 8;
	pixel_x = -26
	},
/obj/structure/cable{
	icon_state = "0-4"
	},
/obj/item/flag/clown,
/turf/simulated/floor/plasteel{
	icon_state = "bar"
	},
/area/clownoffice)
"k" = (
/obj/effect/spawner/window/reinforced,
/obj/machinery/door/poddoor/shutters/preopen{
	id_tag = "Clown";
	name = "Clown Privacy Shutters";
	dir = 8
	},
/obj/machinery/door/poddoor/shutters/preopen{
	id_tag = "Mime";
	name = "Mime Privacy Shutters"
	},
/turf/simulated/floor/plating,
/area/clownoffice)
"l" = (
/obj/structure/window/reinforced{
	dir = 1
	},
/obj/machinery/alarm{
	dir = 8;
	pixel_x = 22
	},
/obj/structure/closet/secure_closet/mime,
/turf/simulated/floor/plasteel{
	dir = 4;
	icon_state = "tranquillite"
	},
/area/mimeoffice)
"m" = (
/obj/structure/cable{
	icon_state = "1-2"
	},
/obj/machinery/atmospherics/pipe/simple/hidden/supply,
/obj/machinery/atmospherics/pipe/simple/hidden/scrubbers,
/obj/machinery/door/airlock/bananium{
	name = "Clown's Office";
	req_access = list(46)
	},
/turf/simulated/floor/plasteel{
	icon_state = "bar"
	},
/area/clownoffice)
"o" = (
/obj/effect/decal/warning_stripes/yellow,
/obj/machinery/door/window/eastright{
	name = "Mime Delivery";
	req_access = list(46);
	dir = 8
	},
/turf/simulated/floor/plasteel{
	dir = 4;
	icon_state = "tranquillite"
	},
/area/mimeoffice)
"p" = (
/obj/machinery/atmospherics/unary/vent_scrubber/on{
	dir = 4
	},
/obj/structure/table/reinforced,
/obj/item/toy/figure/mime{
	pixel_x = -5;
	pixel_y = 1
	},
/obj/item/stamp/mime{
	pixel_x = 5
	},
/turf/simulated/floor/plasteel{
	dir = 4;
	icon_state = "tranquillite"
	},
/area/mimeoffice)
"q" = (
/obj/effect/map_effect/marker/mapmanip/submap/extract/delta/clown_mime,
/turf/template_noop,
/area/template_noop)
"r" = (
/turf/simulated/wall,
/area/clownoffice)
"t" = (
/obj/structure/cable{
	icon_state = "1-2"
	},
/obj/machinery/atmospherics/pipe/simple/hidden/supply,
/obj/machinery/atmospherics/pipe/simple/hidden/scrubbers,
/turf/simulated/floor/plasteel{
	icon_state = "bar"
	},
/area/clownoffice)
"u" = (
/obj/structure/cable{
	icon_state = "1-2"
	},
/obj/machinery/atmospherics/pipe/simple/hidden/supply,
/obj/machinery/atmospherics/pipe/simple/hidden/scrubbers,
/turf/simulated/floor/plasteel{
	dir = 4;
	icon_state = "tranquillite"
	},
/area/mimeoffice)
"v" = (
/obj/machinery/atmospherics/unary/vent_scrubber/on{
	dir = 8
	},
/obj/structure/table/reinforced,
/obj/item/toy/figure/clown{
	pixel_x = 5;
	pixel_y = 1
	},
/obj/item/stamp/clown{
	pixel_x = -5
	},
/turf/simulated/floor/plasteel{
	icon_state = "bar"
	},
/area/clownoffice)
"w" = (
/obj/effect/map_effect/marker_helper/mapmanip/submap/edge{
	dir = 1
	},
/obj/effect/map_effect/marker_helper/mapmanip/submap/edge{
	dir = 8
	},
/turf/template_noop,
/area/template_noop)
"x" = (
/obj/effect/map_effect/marker/mapmanip/submap/extract/delta/clown_mime,
/obj/effect/map_effect/marker_helper/submap_def/delta/clown_mime/shuffle,
/turf/simulated/wall,
/area/clownoffice)
"y" = (
/obj/machinery/atmospherics/unary/vent_pump/on,
/obj/effect/landmark/start/clown,
/turf/simulated/floor/plasteel{
	icon_state = "bar"
	},
/area/clownoffice)
"z" = (
/obj/effect/spawner/window/reinforced,
/obj/machinery/door/poddoor/shutters/preopen{
	id_tag = "Clown";
	name = "Clown Privacy Shutters";
	dir = 8
	},
/obj/machinery/door/poddoor/shutters/preopen{
	id_tag = "Mime";
	name = "Mime Privacy Shutters"
	},
/turf/simulated/floor/plating,
/area/mimeoffice)
"B" = (
/obj/effect/decal/warning_stripes/yellow,
/obj/structure/plasticflaps,
/obj/machinery/navbeacon{
	codes_txt = "delivery;dir=2";
	location = "Clown"
	},
/turf/simulated/floor/plating,
/area/clownoffice)
"C" = (
/obj/effect/spawner/window/reinforced,
/obj/machinery/door/poddoor/shutters/preopen{
	dir = 2;
	id_tag = "Mime";
	name = "Mime Privacy Shutters"
	},
/turf/simulated/floor/plating,
/area/mimeoffice)
"D" = (
/obj/structure/cable{
	icon_state = "1-2"
	},
/obj/machinery/atmospherics/pipe/simple/hidden/supply,
/obj/machinery/atmospherics/pipe/simple/hidden/scrubbers,
/obj/machinery/door/airlock/tranquillite{
	name = "Mime's Office";
	req_access = list(46)
	},
/turf/simulated/floor/plasteel{
	icon_state = "bar"
	},
/area/mimeoffice)
"E" = (
/obj/structure/table/reinforced,
/obj/item/reagent_containers/food/snacks/baguette,
/obj/item/lipstick/random{
	pixel_x = 3;
	pixel_y = 3
	},
/obj/item/lipstick/random{
	pixel_x = -1;
	pixel_y = 1
	},
/obj/item/lipstick/random{
	pixel_x = -3;
	pixel_y = -3
	},
/obj/item/reagent_containers/spray/waterflower,
/turf/simulated/floor/plasteel{
	dir = 4;
	icon_state = "tranquillite"
	},
/area/mimeoffice)
"F" = (
/obj/structure/bed,
/obj/structure/sign/poster/official/random{
	pixel_y = 32
	},
/obj/item/bedsheet/mime,
/obj/machinery/camera{
	c_tag = "Mime Office"
	},
/turf/simulated/floor/plasteel{
	dir = 4;
	icon_state = "tranquillite"
	},
/area/mimeoffice)
"G" = (
/obj/effect/map_effect/marker_helper/mapmanip/submap/edge{
	dir = 4
	},
/obj/effect/map_effect/marker_helper/mapmanip/submap/edge{
	dir = 1
	},
/turf/template_noop,
/area/template_noop)
"H" = (
/obj/machinery/hologram/holopad,
/obj/structure/cable{
	icon_state = "2-4"
	},
/obj/machinery/atmospherics/pipe/simple/hidden/supply,
/obj/machinery/atmospherics/pipe/simple/hidden/scrubbers{
	dir = 10
	},
/obj/effect/landmark/start/mime,
/turf/simulated/floor/plasteel{
	dir = 4;
	icon_state = "tranquillite"
	},
/area/mimeoffice)
"I" = (
/obj/structure/bed,
/obj/structure/sign/poster/official/random{
	pixel_y = 32
	},
/obj/item/bedsheet/clown,
/obj/machinery/camera{
	c_tag = "Clown Office"
	},
/turf/simulated/floor/plasteel{
	icon_state = "bar"
	},
/area/clownoffice)
"J" = (
/obj/effect/decal/warning_stripes/yellow,
/obj/machinery/door/window/eastright{
	name = "Clown Delivery";
	req_access = list(46)
	},
/turf/simulated/floor/plasteel{
	icon_state = "bar"
	},
/area/clownoffice)
"K" = (
/obj/machinery/status_display,
/turf/simulated/wall,
/area/clownoffice)
"L" = (
/obj/structure/statue/tranquillite/mime/unique,
/turf/simulated/floor/plasteel{
	dir = 4;
	icon_state = "tranquillite"
	},
/area/mimeoffice)
"N" = (
/obj/structure/window/reinforced{
	dir = 1
	},
/obj/machinery/alarm{
	dir = 4;
	pixel_x = -22
	},
/obj/structure/closet/secure_closet/clown,
/obj/item/clothing/suit/soldiercoat,
/obj/item/clothing/under/soldieruniform,
/turf/simulated/floor/plasteel{
	icon_state = "bar"
	},
/area/clownoffice)
"O" = (
/obj/structure/table/reinforced,
/obj/item/reagent_containers/food/snacks/grown/banana,
/obj/item/reagent_containers/food/snacks/grown/banana{
	pixel_x = -6;
	pixel_y = 3
	},
/obj/item/reagent_containers/food/snacks/grown/banana{
	pixel_x = 7;
	pixel_y = 3
	},
/obj/item/reagent_containers/food/snacks/pie{
	pixel_y = 7
	},
/turf/simulated/floor/plasteel{
	icon_state = "bar"
	},
/area/clownoffice)
"P" = (
/obj/machinery/atmospherics/unary/vent_pump/on,
/obj/effect/landmark/start/mime,
/turf/simulated/floor/plasteel{
	dir = 4;
	icon_state = "tranquillite"
	},
/area/mimeoffice)
"R" = (
/obj/machinery/vending/autodrobe,
/turf/simulated/floor/plasteel{
	dir = 4;
	icon_state = "tranquillite"
	},
/area/mimeoffice)
"S" = (
/obj/machinery/suit_storage_unit/mime,
/obj/machinery/door_control{
	id = "Mime";
	name = "Mimes Privacy Shutters Control";
	pixel_x = 25;
	pixel_y = -10
	},
/turf/simulated/floor/plasteel{
	dir = 4;
	icon_state = "tranquillite"
	},
/area/mimeoffice)
"U" = (
/obj/effect/map_effect/marker_helper/mapmanip/submap/edge{
	dir = 4
	},
/obj/effect/map_effect/marker_helper/mapmanip/submap/edge{
	dir = 6
	},
/turf/template_noop,
/area/template_noop)
"X" = (
/obj/machinery/vending/autodrobe,
/turf/simulated/floor/plasteel{
	icon_state = "bar"
	},
/area/clownoffice)
"Y" = (
/obj/effect/spawner/window/reinforced,
/obj/machinery/door/poddoor/shutters/preopen{
	dir = 2;
	id_tag = "Clown";
	name = "Clown Privacy Shutters"
	},
/turf/simulated/floor/plating,
/area/clownoffice)
"Z" = (
/obj/machinery/door_control{
	id = "Clown";
	name = "Clowns Privacy Shutters Control";
	pixel_x = -25;
	pixel_y = -10
	},
/obj/machinery/suit_storage_unit/clown,
/turf/simulated/floor/plasteel{
	icon_state = "bar"
	},
/area/clownoffice)

(1,1,1) = {"
a
a
a
a
a
a
a
a
a
a
a
a
a
a
a
a
a
a
"}
(2,1,1) = {"
a
a
a
a
a
a
a
a
a
a
a
a
a
a
a
a
a
a
"}
(3,1,1) = {"
a
a
a
a
a
a
a
a
a
a
a
a
a
a
a
a
a
a
"}
(4,1,1) = {"
a
a
w
a
a
a
a
q
a
a
r
r
r
r
r
x
a
a
"}
(5,1,1) = {"
a
a
a
a
a
a
a
a
a
a
B
J
N
j
Z
Y
a
a
"}
(6,1,1) = {"
a
a
a
a
a
a
a
a
a
a
r
I
y
g
t
m
a
a
"}
(7,1,1) = {"
a
a
a
a
a
a
a
a
a
a
r
X
O
v
h
Y
a
a
"}
(8,1,1) = {"
a
a
a
a
a
a
a
a
a
a
e
e
z
k
K
r
a
a
"}
(9,1,1) = {"
a
a
a
a
a
a
a
a
a
a
e
R
E
p
L
C
a
a
"}
(10,1,1) = {"
a
a
a
a
a
a
a
a
a
a
e
F
P
H
u
D
a
a
"}
(11,1,1) = {"
a
a
a
a
a
a
a
a
a
a
d
o
l
i
S
C
a
a
"}
(12,1,1) = {"
a
a
G
a
a
a
a
U
a
a
b
e
e
e
e
f
a
a
"}
(13,1,1) = {"
a
a
a
a
a
a
a
a
a
a
a
a
a
a
a
a
a
a
"}
(14,1,1) = {"
a
a
a
a
a
a
a
a
a
a
a
a
a
a
a
a
a
a
"}
(15,1,1) = {"
a
a
a
a
a
a
a
a
a
a
a
a
a
a
a
a
a
a
"}
