//MAP CONVERTED BY dmm2tgm.py THIS HEADER COMMENT PREVENTS RECONVERSION, DO NOT REMOVE
"a" = (
/turf/cordon,
/area/space)
"d" = (
/obj/structure/inflatable/door,
/turf/simulated/floor/indestructible/bingle,
/area/misc/bingle_pit)
"h" = (
/obj/structure/toilet/golden_toilet,
/turf/simulated/floor/indestructible/bingle,
/area/misc/bingle_pit)
"i" = (
/obj/machinery/hydroponics/soil,
/turf/simulated/floor/indestructible/bingle,
/area/misc/bingle_pit)
"l" = (
/obj/effect/area_lighting_helper/max_alpha_blue,
/turf/simulated/floor/indestructible/bingle,
/area/misc/bingle_pit)
"t" = (
/obj/item/deck/cards/syndicate,
/turf/simulated/floor/indestructible/bingle,
/area/misc/bingle_pit)
"u" = (
/obj/item/trash/sosjerky,
/turf/simulated/floor/indestructible/bingle,
/area/misc/bingle_pit)
"v" = (
/mob/living/simple_animal/pet/gondola,
/turf/simulated/floor/indestructible/bingle,
/area/misc/bingle_pit)
"D" = (
/turf/simulated/wall/indestructible/bingle,
/area/misc/bingle_pit)
"H" = (
/obj/effect/decal/remains/human,
/turf/simulated/floor/indestructible/bingle,
/area/misc/bingle_pit)
"L" = (
/turf/simulated/floor/indestructible/bingle,
/area/misc/bingle_pit)
"M" = (
/obj/item/seeds/wheat,
/turf/simulated/floor/indestructible/bingle,
/area/misc/bingle_pit)
"R" = (
/obj/item/card/id/captains_spare,
/turf/simulated/floor/indestructible/bingle,
/area/misc/bingle_pit)
"T" = (
/obj/structure/table,
/turf/simulated/floor/indestructible/bingle,
/area/misc/bingle_pit)
"U" = (
/turf/space,
/area/space)
"V" = (
/obj/effect/mob_spawn/human/skeleton,
/turf/simulated/floor/indestructible/bingle,
/area/misc/bingle_pit)
"Y" = (
/obj/machinery/gameboard,
/turf/simulated/floor/indestructible/bingle,
/area/misc/bingle_pit)
"Z" = (
/obj/item/storage/toolbox/surgery/ashwalker,
/turf/simulated/floor/indestructible/bingle,
/area/misc/bingle_pit)

(1,1,1) = {"
a
a
a
a
a
a
a
a
a
a
a
a
a
a
a
a
a
a
a
a
a
a
a
a
a
a
a
a
a
a
a
a
a
a
a
a
a
a
"}
(2,1,1) = {"
a
a
a
a
a
a
a
a
a
a
a
a
a
a
a
a
a
a
a
a
a
a
a
a
a
a
a
a
a
a
a
a
a
a
a
a
a
a
"}
(3,1,1) = {"
a
a
U
U
U
U
U
U
U
U
U
U
U
U
U
U
U
U
U
U
U
U
U
U
U
U
U
U
U
U
U
U
U
U
U
U
a
a
"}
(4,1,1) = {"
a
a
U
U
U
U
U
U
U
U
U
U
U
U
D
D
D
D
D
D
D
D
D
U
U
U
U
U
U
U
D
D
D
U
U
U
a
a
"}
(5,1,1) = {"
a
a
U
U
U
U
U
D
D
D
D
D
D
D
D
L
L
L
L
L
i
i
D
U
U
U
D
D
D
D
D
L
D
U
U
U
a
a
"}
(6,1,1) = {"
a
a
U
U
U
U
D
D
v
L
L
L
L
L
L
L
L
L
D
L
L
L
D
U
U
U
D
L
L
L
L
L
D
D
D
U
a
a
"}
(7,1,1) = {"
a
a
U
D
D
D
D
L
L
L
L
L
L
L
L
L
L
D
D
L
M
L
D
D
D
D
D
L
L
L
L
L
L
v
D
U
a
a
"}
(8,1,1) = {"
a
a
U
D
L
h
D
L
L
L
L
L
L
L
L
L
L
u
L
L
L
L
L
L
L
L
L
L
L
L
H
L
L
L
D
U
a
a
"}
(9,1,1) = {"
a
a
U
D
L
D
D
L
L
L
L
D
D
L
L
L
L
L
L
L
L
L
L
L
L
L
L
L
L
L
L
L
L
L
D
U
a
a
"}
(10,1,1) = {"
a
a
U
D
L
d
L
L
L
L
L
L
L
L
L
L
L
L
L
H
L
L
L
L
L
L
L
L
L
L
L
L
L
L
D
U
a
a
"}
(11,1,1) = {"
a
a
U
D
D
D
L
L
L
L
L
L
L
L
L
L
L
L
L
L
L
L
M
L
L
L
L
L
L
D
L
L
L
L
D
U
a
a
"}
(12,1,1) = {"
a
a
U
U
U
D
L
L
L
L
L
L
L
L
u
L
L
L
L
L
L
L
L
L
L
L
L
L
L
D
L
L
L
L
D
U
a
a
"}
(13,1,1) = {"
a
a
U
U
U
D
L
L
L
L
L
L
L
L
L
L
L
L
L
L
L
L
L
L
L
L
L
L
L
L
u
L
L
L
D
U
a
a
"}
(14,1,1) = {"
a
a
U
U
U
D
L
L
L
H
L
L
D
L
L
L
D
D
D
D
D
D
D
L
L
L
L
L
L
L
L
L
L
L
D
U
a
a
"}
(15,1,1) = {"
a
a
U
U
U
D
D
L
L
L
L
L
L
L
D
L
D
T
T
T
Z
L
D
L
L
Y
L
L
L
L
L
L
L
L
D
U
a
a
"}
(16,1,1) = {"
a
a
U
U
U
U
D
L
L
L
L
L
L
L
L
L
D
L
L
L
L
L
D
L
L
L
L
L
L
L
L
L
D
D
D
U
a
a
"}
(17,1,1) = {"
a
a
U
U
U
D
D
L
L
L
M
L
L
L
L
L
D
t
L
L
L
L
D
L
L
L
L
L
L
L
L
L
D
D
D
U
a
a
"}
(18,1,1) = {"
a
a
U
U
U
D
D
L
L
L
L
L
L
L
L
L
L
L
L
L
L
L
L
L
L
L
L
L
L
H
L
L
D
U
U
U
a
a
"}
(19,1,1) = {"
a
a
U
U
U
D
L
L
L
L
L
L
L
L
L
D
D
L
L
L
u
L
L
L
L
L
L
D
L
L
L
L
D
U
U
U
a
a
"}
(20,1,1) = {"
a
a
U
U
U
D
L
L
L
L
u
L
L
L
L
L
D
L
l
L
L
L
L
L
L
L
L
L
L
L
L
L
D
U
U
U
a
a
"}
(21,1,1) = {"
a
a
U
U
U
D
L
L
L
L
L
L
L
L
L
L
L
L
L
L
L
L
L
L
L
L
L
L
D
L
L
L
D
U
U
U
a
a
"}
(22,1,1) = {"
a
a
U
U
U
D
L
L
L
L
L
D
i
L
L
L
L
L
L
D
D
L
L
L
V
L
L
D
D
L
L
L
D
U
U
U
a
a
"}
(23,1,1) = {"
a
a
U
U
U
D
D
L
L
L
L
D
i
L
M
L
L
L
L
L
L
L
L
L
L
L
L
L
L
L
L
L
D
D
D
U
a
a
"}
(24,1,1) = {"
a
a
U
U
U
U
D
L
L
L
L
L
L
L
L
L
L
L
D
D
L
L
L
D
L
L
L
L
L
L
L
L
D
L
D
U
a
a
"}
(25,1,1) = {"
a
a
U
U
U
U
D
L
L
L
L
L
L
H
L
L
L
L
L
L
L
L
L
L
L
L
L
L
L
L
L
L
D
L
D
U
a
a
"}
(26,1,1) = {"
a
a
U
U
U
D
D
L
H
L
L
L
L
L
L
L
L
L
L
L
L
L
L
L
L
L
L
L
L
u
L
L
L
L
D
U
a
a
"}
(27,1,1) = {"
a
a
U
U
U
D
L
L
L
L
L
L
L
L
L
L
L
L
L
L
L
L
L
L
L
L
L
L
L
L
L
L
L
L
D
U
a
a
"}
(28,1,1) = {"
a
a
U
U
U
D
L
L
L
D
L
L
L
L
L
L
L
L
L
D
L
L
L
L
L
L
L
L
L
L
L
L
L
L
D
U
a
a
"}
(29,1,1) = {"
a
a
U
U
D
D
L
L
L
D
D
L
L
D
D
L
L
L
D
D
L
L
L
L
L
L
D
D
L
L
L
L
L
L
D
U
a
a
"}
(30,1,1) = {"
a
a
U
U
D
L
L
L
L
L
L
L
L
L
L
L
L
L
L
L
L
L
L
L
L
L
D
L
L
H
L
L
L
L
D
U
a
a
"}
(31,1,1) = {"
a
a
U
U
D
R
L
L
L
L
L
L
L
L
L
L
L
L
L
L
L
u
L
L
L
L
L
L
L
L
L
L
L
L
D
U
a
a
"}
(32,1,1) = {"
a
a
U
U
D
D
L
L
L
L
L
L
L
D
D
D
D
D
L
L
L
L
L
L
L
L
L
L
L
L
L
L
L
L
D
U
a
a
"}
(33,1,1) = {"
a
a
U
U
D
D
D
D
D
D
L
L
L
D
U
U
D
D
D
L
L
L
L
D
D
D
D
D
L
L
L
L
D
D
D
U
a
a
"}
(34,1,1) = {"
a
a
U
U
U
U
U
U
U
D
D
D
D
D
U
U
U
U
D
D
L
L
L
D
U
U
U
D
D
D
D
D
D
U
U
U
a
a
"}
(35,1,1) = {"
a
a
U
U
U
U
U
U
U
U
U
U
U
U
U
U
U
U
U
D
D
D
D
D
U
U
U
U
U
U
U
U
U
U
U
U
a
a
"}
(36,1,1) = {"
a
a
a
a
a
a
a
a
a
a
a
a
a
a
a
a
a
a
a
a
a
a
a
a
a
a
a
a
a
a
a
a
a
a
a
a
a
a
"}
(37,1,1) = {"
a
a
a
a
a
a
a
a
a
a
a
a
a
a
a
a
a
a
a
a
a
a
a
a
a
a
a
a
a
a
a
a
a
a
a
a
a
a
"}
