//MAP CONVERTED BY dmm2tgm.py THIS HEADER COMMENT PREVENTS RECONVERSION, DO NOT REMOVE
"a" = (
/turf/simulated/mineral/volcanic/lava_land_surface,
/area/lavaland/surface/outdoors)
"b" = (
/turf/simulated/mineral/volcanic/lava_land_surface,
/area/ruin/powered/lavaland)
"c" = (
/turf/simulated/wall/mineral/iron,
/area/ruin/powered/lavaland)
"d" = (
/obj/item/clothing/head/helmet/space/syndicate/orange,
/obj/item/clothing/mask/breath,
/turf/simulated/floor/plating/asteroid/basalt,
/area/ruin/powered/lavaland)
"e" = (
/obj/item/clothing/suit/space/syndicate/orange,
/turf/simulated/floor/plating/asteroid/basalt,
/area/ruin/powered/lavaland)
"f" = (
/turf/simulated/floor/plating/asteroid/basalt,
/area/ruin/powered/lavaland)
"g" = (
/turf/simulated/floor/plating/asteroid{
	name = "dirt"
	},
/area/ruin/powered/lavaland)
"h" = (
/obj/item/shovel,
/turf/simulated/floor/plating/asteroid{
	name = "dirt"
	},
/area/ruin/powered/lavaland)
"i" = (
/obj/item/reagent_containers/glass/bucket,
/turf/simulated/floor/plating/asteroid{
	name = "dirt"
	},
/area/ruin/powered/lavaland)
"j" = (
/obj/structure/sink/puddle,
/turf/simulated/floor/plating/asteroid{
	name = "dirt"
	},
/area/ruin/powered/lavaland)
"k" = (
/obj/structure/glowshroom/single,
/turf/simulated/floor/plating/asteroid{
	name = "dirt"
	},
/area/ruin/powered/lavaland)
"l" = (
/obj/item/storage/toolbox/mechanical,
/turf/simulated/floor/plating/asteroid{
	name = "dirt"
	},
/area/ruin/powered/lavaland)
"m" = (
/obj/structure/rack,
/obj/item/seeds/reishi,
/obj/item/seeds/plump,
/obj/item/seeds/plump,
/obj/item/reagent_containers/food/snacks/grown/mushroom/glowshroom,
/obj/item/seeds/tower,
/turf/simulated/floor/plating/asteroid/basalt,
/area/ruin/powered/lavaland)
"n" = (
/obj/machinery/hydroponics/soil,
/turf/simulated/floor/plating,
/area/ruin/powered/lavaland)
"o" = (
/turf/simulated/floor/plating,
/area/ruin/powered/lavaland)
"p" = (
/obj/structure/rack,
/obj/item/storage/bag/plants/portaseeder,
/obj/item/storage/bag/ore,
/obj/item/storage/firstaid/regular,
/obj/item/hatchet/wooden,
/turf/simulated/floor/plating/asteroid/basalt,
/area/ruin/powered/lavaland)
"q" = (
/obj/structure/glowshroom/single,
/turf/simulated/floor/plating,
/area/ruin/powered/lavaland)
"r" = (
/obj/structure/rack,
/obj/item/pickaxe/emergency,
/obj/item/tank/internals/oxygen,
/turf/simulated/floor/plating/asteroid/basalt,
/area/ruin/powered/lavaland)
"s" = (
/obj/effect/mapping_helpers/no_lava,
/turf/simulated/floor/plating/asteroid/basalt/lava_land_surface,
/area/lavaland/surface/outdoors)
"t" = (
/turf/simulated/wall/mineral/titanium/survival/pod,
/area/ruin/powered/lavaland)
"u" = (
/obj/structure/bed/pod,
/obj/item/bedsheet/black,
/turf/simulated/floor/plating,
/area/ruin/powered/lavaland)
"v" = (
/obj/structure/fans,
/turf/simulated/floor/pod/dark,
/area/ruin/powered/lavaland)
"w" = (
/obj/machinery/smartfridge/survival_pod,
/turf/simulated/floor/pod/dark,
/area/ruin/powered/lavaland)
"x" = (
/obj/effect/mob_spawn/human/hermit,
/turf/simulated/floor/pod/dark,
/area/ruin/powered/lavaland)
"y" = (
/turf/simulated/floor/pod/dark,
/area/ruin/powered/lavaland)
"z" = (
/obj/machinery/light/small{
	dir = 4
	},
/obj/structure/tubes,
/turf/simulated/floor/plating,
/area/ruin/powered/lavaland)
"A" = (
/obj/structure/table,
/obj/item/kitchen/knife/combat/survival,
/turf/simulated/floor/plating,
/area/ruin/powered/lavaland)
"B" = (
/obj/structure/table/survival_pod,
/turf/simulated/floor/pod/dark,
/area/ruin/powered/lavaland)
"C" = (
/obj/structure/tubes,
/obj/item/crowbar,
/obj/effect/decal/cleanable/blood/drip,
/turf/simulated/floor/pod/dark,
/area/ruin/powered/lavaland)
"D" = (
/obj/effect/decal/cleanable/blood/footprints{
	dir = 1
	},
/obj/machinery/door/airlock/survival_pod/glass,
/obj/structure/fans/tiny,
/turf/simulated/floor/pod/dark,
/area/ruin/powered/lavaland)
"E" = (
/obj/structure/shuttle/engine/propulsion/burst{
	dir = 8
	},
/turf/simulated/wall/mineral/titanium/interior,
/area/ruin/powered/lavaland)
"F" = (
/turf/simulated/wall/mineral/titanium,
/area/ruin/powered/lavaland)
"G" = (
/turf/simulated/wall/mineral/titanium/interior,
/area/ruin/powered/lavaland)
"H" = (
/obj/machinery/door/airlock/titanium{
	name = "Escape Pod Airlock"
	},
/obj/structure/fans/tiny,
/turf/simulated/floor/mineral/titanium/blue,
/area/ruin/powered/lavaland)
"I" = (
/obj/structure/chair/comfy/shuttle{
	dir = 4
	},
/turf/simulated/floor/mineral/titanium/blue,
/area/ruin/powered/lavaland)
"J" = (
/obj/effect/spawner/window/shuttle,
/turf/simulated/floor/plating,
/area/ruin/powered/lavaland)
"K" = (
/obj/effect/baseturf_helper/lava_land/surface,
/turf/simulated/floor/plating,
/area/ruin/powered/lavaland)
"M" = (
/obj/item/cultivator/rake{
	desc = "Эту тяпку создал великий столяр, на кончике красуется змей, который обвивает рукоять. Детализация чешуек просто поражает, глаза холодно смотрят прямо в душу, несмотря на спокойное состояние змея.";
	name = "Резная тяпка"
	},
/turf/simulated/floor/plating,
/area/ruin/powered/lavaland)
"X" = (
/obj/item/flashlight/lantern,
/turf/simulated/floor/plating/asteroid/basalt,
/area/ruin/powered/lavaland)
"Y" = (
/obj/structure/bonfire,
/turf/simulated/floor/plating/asteroid/basalt,
/area/ruin/powered/lavaland)

(1,1,1) = {"
a
a
a
a
a
a
a
a
a
a
s
s
s
s
s
s
s
s
"}
(2,1,1) = {"
a
a
a
a
a
a
a
a
a
a
a
a
s
s
s
s
s
s
"}
(3,1,1) = {"
a
a
a
a
a
a
a
a
a
a
a
a
s
s
s
s
s
s
"}
(4,1,1) = {"
a
a
a
a
a
a
a
a
a
a
a
a
a
s
s
s
s
s
"}
(5,1,1) = {"
a
a
a
a
a
a
a
b
c
b
t
t
t
t
t
s
s
s
"}
(6,1,1) = {"
a
a
a
a
a
a
b
b
n
n
t
v
x
B
t
s
s
s
"}
(7,1,1) = {"
a
a
a
a
a
b
b
m
M
o
t
w
y
y
D
s
s
s
"}
(8,1,1) = {"
a
a
a
b
b
b
c
f
o
q
K
o
z
C
t
s
s
s
"}
(9,1,1) = {"
a
a
b
b
f
i
g
f
Y
o
o
o
t
t
t
s
s
s
"}
(10,1,1) = {"
a
a
b
d
g
j
g
g
f
f
u
o
A
b
a
s
s
s
"}
(11,1,1) = {"
a
a
c
e
h
g
l
c
p
r
c
c
c
b
a
a
s
s
"}
(12,1,1) = {"
a
a
b
b
f
k
X
b
b
b
b
a
a
a
a
E
H
E
"}
(13,1,1) = {"
a
a
a
b
b
b
b
b
a
a
a
a
a
a
a
F
I
F
"}
(14,1,1) = {"
a
a
a
a
a
a
a
a
a
a
a
a
a
a
a
F
I
F
"}
(15,1,1) = {"
a
a
a
a
a
a
a
a
a
a
a
a
a
a
a
G
J
G
"}
(16,1,1) = {"
a
a
a
a
a
a
a
a
a
a
a
a
a
a
a
a
a
a
"}
(17,1,1) = {"
a
a
a
a
a
a
a
a
a
a
a
a
a
a
a
a
a
a
"}
(18,1,1) = {"
a
a
a
a
a
a
a
a
a
a
a
a
a
a
a
a
a
s
"}
