//MAP CONVERTED BY dmm2tgm.py THIS HEADER COMMENT PREVENTS RECONVERSION, DO NOT REMOVE
"aa" = (
/turf/space,
/area/space)
"ab" = (
/obj/structure/marker_beacon{
	icon_state = "markerjade-on"
	},
/obj/structure/lattice/catwalk,
/obj/machinery/porta_turret{
	installation = /obj/item/gun/energy/gun
	},
/turf/simulated/floor/shuttle/transparent_floor{
	dir = 6;
	icon = 'icons/turf/shuttle/misc.dmi';
	icon_state = "router_dir"
	},
/area/shuttle/escape)
"ad" = (
/obj/structure/lattice/catwalk,
/obj/structure/marker_beacon{
	icon_state = "markerjade-on"
	},
/obj/machinery/porta_turret{
	installation = /obj/item/gun/energy/gun
	},
/turf/simulated/floor/shuttle/transparent_floor{
	dir = 4;
	icon = 'icons/turf/shuttle/misc.dmi';
	icon_state = "tube"
	},
/area/shuttle/escape)
"ag" = (
/obj/machinery/computer/security,
/turf/simulated/floor/plasteel{
	dir = 1;
	icon_state = "navyblue"
	},
/area/shuttle/escape)
"ak" = (
/obj/structure/chair/comfy/shuttle/dark{
	dir = 1
	},
/turf/simulated/floor/plasteel{
	dir = 8;
	icon_state = "navyblue"
	},
/area/shuttle/escape)
"an" = (
/obj/structure/chair/comfy/shuttle/dark{
	dir = 1
	},
/turf/simulated/floor/plasteel{
	icon_state = "dark"
	},
/area/shuttle/escape)
"ao" = (
/obj/structure/chair/comfy/shuttle/dark{
	dir = 1
	},
/turf/simulated/floor/plasteel{
	dir = 4;
	icon_state = "navyblue"
	},
/area/shuttle/escape)
"ap" = (
/obj/machinery/computer/robotics,
/turf/simulated/floor/plasteel{
	dir = 9;
	icon_state = "navyblue"
	},
/area/shuttle/escape)
"as" = (
/obj/structure/chair/comfy/shuttle/dark,
/turf/simulated/floor/shuttle/objective_check,
/area/shuttle/escape)
"at" = (
/obj/structure/closet/walllocker/emerglocker/directional/east,
/mob/living/simple_animal/bot/ed209,
/turf/simulated/floor/plasteel{
	dir = 4;
	icon_state = "navybluefull"
	},
/area/shuttle/escape)
"au" = (
/turf/simulated/floor/plasteel{
	dir = 1;
	icon_state = "navybluecorners"
	},
/area/shuttle/escape)
"av" = (
/obj/machinery/computer/communications,
/turf/simulated/floor/plasteel{
	dir = 1;
	icon_state = "navyblue"
	},
/area/shuttle/escape)
"aw" = (
/obj/machinery/computer/emergency_shuttle,
/turf/simulated/floor/plasteel{
	dir = 1;
	icon_state = "navyblue"
	},
/area/shuttle/escape)
"ay" = (
/obj/machinery/computer/crew,
/obj/machinery/light/spot{
	dir = 4
	},
/turf/simulated/floor/mineral/titanium/blue,
/area/shuttle/escape)
"aB" = (
/obj/machinery/computer/station_alert,
/turf/simulated/floor/plasteel{
	dir = 5;
	icon_state = "navyblue"
	},
/area/shuttle/escape)
"aC" = (
/obj/structure/marker_beacon{
	icon_state = "markerjade-on"
	},
/obj/structure/lattice/catwalk,
/obj/machinery/porta_turret{
	installation = /obj/item/gun/energy/gun
	},
/turf/simulated/floor/shuttle/transparent_floor{
	dir = 10;
	icon = 'icons/turf/shuttle/misc.dmi';
	icon_state = "router_dir"
	},
/area/shuttle/escape)
"aE" = (
/turf/simulated/wall/mineral/plastitanium/nodiagonal,
/area/shuttle/escape)
"aF" = (
/obj/structure/chair/comfy/shuttle/dark{
	dir = 4
	},
/turf/simulated/floor/shuttle/objective_check,
/area/shuttle/escape)
"aG" = (
/turf/simulated/wall/mineral/plastitanium,
/area/shuttle/escape)
"aI" = (
/turf/simulated/floor/plasteel{
	icon_state = "dark"
	},
/area/shuttle/escape)
"aJ" = (
/obj/machinery/atmospherics/unary/cryo_cell,
/turf/simulated/floor/mineral/titanium/blue,
/area/shuttle/escape)
"aK" = (
/obj/machinery/atmospherics/unary/portables_connector,
/obj/machinery/portable_atmospherics/canister/oxygen{
	name = "Canister: \[O2] (CRYO)"
	},
/obj/item/wrench,
/obj/machinery/status_display{
	pixel_y = 30
	},
/obj/machinery/light/spot{
	dir = 1
	},
/turf/simulated/floor/mineral/titanium/blue,
/area/shuttle/escape)
"aL" = (
/turf/simulated/floor/plasteel{
	dir = 4;
	icon_state = "navybluecorners"
	},
/area/shuttle/escape)
"aM" = (
/obj/machinery/sleeper,
/obj/structure/extinguisher_cabinet/directional/east,
/turf/simulated/floor/mineral/titanium/blue,
/area/shuttle/escape)
"aO" = (
/turf/simulated/floor/shuttle/objective_check,
/area/shuttle/escape)
"aQ" = (
/obj/machinery/atmospherics/pipe/manifold/hidden{
	dir = 8
	},
/turf/simulated/floor/mineral/titanium/blue,
/area/shuttle/escape)
"aR" = (
/obj/machinery/atmospherics/pipe/simple/hidden{
	dir = 9
	},
/turf/simulated/floor/mineral/titanium/blue,
/area/shuttle/escape)
"aS" = (
/turf/simulated/floor/mineral/titanium/blue,
/area/shuttle/escape)
"aT" = (
/obj/machinery/vending/wallmed{
	layer = 3.3;
	name = "Emergency NanoMed";
	pixel_x = 28
	},
/obj/machinery/bodyscanner,
/turf/simulated/floor/mineral/titanium/blue,
/area/shuttle/escape)
"aU" = (
/obj/machinery/atmospherics/pipe/simple/hidden,
/turf/simulated/floor/mineral/titanium/blue,
/area/shuttle/escape)
"aV" = (
/obj/item/radio/intercom/directional/east,
/obj/machinery/optable,
/obj/item/mounted/shower{
	dir = 8
	},
/turf/simulated/floor/mineral/titanium/blue,
/area/shuttle/escape)
"aW" = (
/obj/machinery/door/airlock/hatch{
	req_access = 63
	},
/obj/structure/fans/tiny,
/turf/simulated/floor/shuttle/objective_check,
/area/shuttle/escape)
"aX" = (
/obj/structure/chair/comfy/shuttle/dark{
	dir = 1
	},
/turf/simulated/floor/shuttle/objective_check,
/area/shuttle/escape)
"aZ" = (
/obj/structure/table,
/obj/item/reagent_containers/glass/beaker/cryoxadone,
/obj/item/roller/holo,
/obj/item/roller/holo,
/obj/item/storage/toolbox/surgery/advanced,
/obj/item/storage/firstaid/regular,
/obj/item/storage/firstaid/regular,
/obj/item/storage/firstaid/fire,
/obj/item/storage/firstaid/adv,
/turf/simulated/floor/mineral/titanium/blue,
/area/shuttle/escape)
"ba" = (
/obj/structure/chair/comfy/shuttle{
	dir = 4
	},
/obj/structure/extinguisher_cabinet/directional/west,
/turf/simulated/floor/mineral/titanium/blue,
/area/shuttle/escape)
"bb" = (
/obj/machinery/vending/medical{
	all_products_free = 1
	},
/turf/simulated/floor/mineral/titanium/blue,
/area/shuttle/escape)
"bc" = (
/obj/machinery/door/airlock/security/glass{
	name = "Escape Shuttle Cell";
	req_access = list(63)
	},
/turf/simulated/floor/shuttle/objective_check,
/area/shuttle/escape)
"bd" = (
/obj/structure/noticeboard,
/turf/simulated/wall/mineral/plastitanium,
/area/shuttle/escape)
"be" = (
/obj/effect/spawner/window/shuttle/gray,
/turf/simulated/floor/plating,
/area/shuttle/escape)
"bf" = (
/obj/machinery/door/airlock/command/glass{
	name = "Escape Shuttle Cockpit";
	req_access = list(19)
	},
/turf/simulated/floor/mineral/titanium/blue,
/area/shuttle/escape)
"bh" = (
/obj/machinery/door/airlock/hatch,
/obj/structure/fans/tiny,
/obj/docking_port/mobile/emergency{
	dwidth = 11;
	height = 13;
	timid = 1;
	width = 24;
	port_direction = 8
	},
/turf/simulated/floor/plasteel{
	icon_state = "dark"
	},
/area/shuttle/escape)
"bj" = (
/obj/item/radio/intercom/directional/west,
/obj/machinery/light/spot{
	dir = 8
	},
/obj/structure/chair/comfy/shuttle/dark{
	dir = 4
	},
/turf/simulated/floor/plasteel{
	dir = 8;
	icon_state = "vault"
	},
/area/shuttle/escape)
"bk" = (
/obj/structure/chair/comfy/shuttle/dark{
	dir = 8
	},
/turf/simulated/floor/plasteel{
	dir = 8;
	icon_state = "vault"
	},
/area/shuttle/escape)
"bl" = (
/obj/structure/chair/comfy/shuttle/dark{
	dir = 4
	},
/turf/simulated/floor/plasteel{
	dir = 8;
	icon_state = "vault"
	},
/area/shuttle/escape)
"bm" = (
/obj/machinery/light/spot{
	dir = 4
	},
/obj/structure/chair/comfy/shuttle/dark{
	dir = 8
	},
/turf/simulated/floor/plasteel{
	dir = 8;
	icon_state = "vault"
	},
/area/shuttle/escape)
"bn" = (
/obj/machinery/light/spot{
	dir = 8
	},
/obj/structure/chair/comfy/shuttle/dark{
	dir = 4
	},
/turf/simulated/floor/plasteel{
	dir = 8;
	icon_state = "vault"
	},
/area/shuttle/escape)
"bq" = (
/obj/machinery/door/airlock/hatch,
/obj/structure/fans/tiny,
/turf/simulated/floor/plasteel{
	icon_state = "dark"
	},
/area/shuttle/escape)
"br" = (
/mob/living/simple_animal/bot/ed209,
/turf/simulated/floor/plasteel{
	icon_state = "dark"
	},
/area/shuttle/escape)
"bs" = (
/turf/simulated/floor/plasteel{
	dir = 4;
	icon_state = "navybluefull"
	},
/area/shuttle/escape)
"bu" = (
/obj/structure/window/reinforced{
	dir = 1
	},
/obj/structure/shuttle/engine/heater,
/turf/simulated/floor/shuttle/plating,
/area/shuttle/escape)
"bv" = (
/obj/structure/shuttle/engine/heater,
/obj/structure/window/reinforced{
	dir = 1
	},
/turf/simulated/floor/shuttle/plating,
/area/shuttle/escape)
"bx" = (
/obj/structure/shuttle/engine/propulsion,
/turf/simulated/floor/shuttle/plating,
/area/shuttle/escape)
"by" = (
/obj/structure/lattice/catwalk,
/obj/machinery/porta_turret{
	installation = /obj/item/gun/energy/gun
	},
/turf/simulated/floor/shuttle/transparent_floor{
	dir = 5;
	icon = 'icons/turf/shuttle/misc.dmi';
	icon_state = "router_dir"
	},
/area/shuttle/escape)
"bz" = (
/obj/structure/lattice/catwalk,
/obj/structure/marker_beacon{
	icon_state = "markerjade-on"
	},
/obj/machinery/porta_turret{
	installation = /obj/item/gun/energy/gun
	},
/turf/simulated/floor/shuttle/transparent_floor{
	dir = 1;
	icon = 'icons/turf/shuttle/misc.dmi';
	icon_state = "router_dir"
	},
/area/shuttle/escape)
"hC" = (
/obj/machinery/light/spot{
	dir = 1
	},
/obj/machinery/status_display{
	pixel_y = 30
	},
/obj/structure/chair/comfy/shuttle/dark,
/turf/simulated/floor/shuttle/objective_check,
/area/shuttle/escape)
"jJ" = (
/obj/item/flag/nt,
/turf/simulated/floor/plasteel{
	dir = 8;
	icon_state = "vault"
	},
/area/shuttle/escape)
"mf" = (
/obj/machinery/turretid/stun{
	name = "Shuttle Turret Control";
	pixel_y = 30;
	check_records = 0
	},
/turf/simulated/wall/mineral/plastitanium,
/area/shuttle/escape)
"pO" = (
/obj/machinery/door/airlock/command/glass{
	req_access = list(19)
	},
/turf/simulated/floor/plasteel{
	dir = 1;
	icon_state = "dark"
	},
/area/shuttle/escape)
"pT" = (
/obj/machinery/atmospherics/unary/thermomachine/freezer{
	dir = 1
	},
/turf/simulated/floor/mineral/titanium/blue,
/area/shuttle/escape)
"qo" = (
/obj/machinery/door/airlock/vault{
	req_access = list(19)
	},
/turf/simulated/floor/plasteel{
	dir = 1;
	icon_state = "dark"
	},
/area/shuttle/escape)
"qL" = (
/obj/structure/chair/comfy/shuttle/dark{
	dir = 4
	},
/obj/structure/extinguisher_cabinet/directional/west,
/turf/simulated/floor/shuttle/objective_check,
/area/shuttle/escape)
"rt" = (
/obj/machinery/recharge_station,
/turf/simulated/floor/plasteel{
	dir = 8;
	icon_state = "vault"
	},
/area/shuttle/escape)
"xY" = (
/obj/structure/chair/comfy/shuttle/dark{
	dir = 8
	},
/obj/machinery/light/spot,
/turf/simulated/floor/plasteel{
	icon_state = "dark"
	},
/area/shuttle/escape)
"Ap" = (
/obj/structure/extinguisher_cabinet/directional/south,
/turf/simulated/floor/plasteel{
	icon_state = "dark"
	},
/area/shuttle/escape)
"GD" = (
/obj/machinery/door/airlock/vault{
	req_access = list(63)
	},
/turf/simulated/floor/shuttle/objective_check,
/area/shuttle/escape)
"Lj" = (
/obj/structure/chair/comfy/shuttle/dark{
	dir = 4
	},
/obj/machinery/light/spot,
/turf/simulated/floor/plasteel{
	icon_state = "dark"
	},
/area/shuttle/escape)
"Mv" = (
/obj/structure/chair/comfy/shuttle/dark,
/obj/structure/extinguisher_cabinet/directional/west,
/turf/simulated/floor/shuttle/objective_check,
/area/shuttle/escape)
"Px" = (
/obj/structure/closet/walllocker/emerglocker/directional/west,
/obj/structure/chair/comfy/shuttle/dark{
	dir = 4
	},
/turf/simulated/floor/shuttle/objective_check,
/area/shuttle/escape)
"Tm" = (
/obj/structure/lattice/catwalk,
/obj/machinery/porta_turret{
	installation = /obj/item/gun/energy/gun
	},
/turf/simulated/floor/shuttle/transparent_floor{
	dir = 9;
	icon = 'icons/turf/shuttle/misc.dmi';
	icon_state = "router_dir"
	},
/area/shuttle/escape)
"UH" = (
/obj/structure/chair/comfy/shuttle/dark,
/obj/machinery/light/spot{
	dir = 4
	},
/turf/simulated/floor/shuttle/objective_check,
/area/shuttle/escape)
"XP" = (
/obj/structure/closet/walllocker/emerglocker/directional/east,
/turf/simulated/floor/plasteel{
	icon_state = "dark"
	},
/area/shuttle/escape)

(1,1,1) = {"
aa
aa
aG
aG
be
aE
aG
aG
aG
aW
aG
bh
aG
aG
aG
aG
aG
bq
be
bq
aG
aG
aG
aa
"}
(2,1,1) = {"
aa
ab
aG
Mv
aO
aG
aF
Px
qL
aO
aG
bs
bj
bl
bl
bl
bn
bs
bs
bs
bl
bn
aE
aG
"}
(3,1,1) = {"
aa
ad
aG
UH
aO
GD
aO
aO
aO
aO
bc
bs
bs
bs
bs
bs
bs
bs
bs
bs
bs
bs
bu
bx
"}
(4,1,1) = {"
be
be
aE
aG
aG
aE
hC
aO
aO
aX
aG
bs
bk
bk
bk
bk
bk
aI
bk
bk
bk
aI
bu
bx
"}
(5,1,1) = {"
be
ap
ak
au
Lj
aG
as
aO
aO
aX
bd
bs
bl
bl
bl
bl
bl
aI
bl
bl
bl
Ap
aE
aG
"}
(6,1,1) = {"
be
av
an
aI
Ap
aG
be
be
be
be
be
aI
aI
aI
aI
aI
aI
aI
aI
aI
aI
rt
aG
by
"}
(7,1,1) = {"
be
ag
an
aI
aI
qo
aI
aI
aI
aI
pO
aI
aI
jJ
aI
aI
aI
jJ
aI
aI
aI
jJ
aG
bz
"}
(8,1,1) = {"
be
aw
an
aI
Ap
aG
be
be
be
be
be
aI
aI
aI
aI
aI
aI
aI
aI
aI
aI
rt
aG
Tm
"}
(9,1,1) = {"
be
aB
ao
aL
xY
aG
aJ
aQ
aU
pT
aG
bs
bk
bk
bk
bk
bk
aI
bk
bk
bk
Ap
aE
aG
"}
(10,1,1) = {"
be
be
aE
mf
aG
aE
aK
aR
aS
aZ
aG
bs
bl
bl
bl
bl
bl
aI
bl
bl
bl
aI
bv
bx
"}
(11,1,1) = {"
aa
ad
aG
ba
aS
bf
aS
aS
aS
aS
bf
bs
bs
bs
bs
bs
bs
bs
bs
bs
bs
bs
bv
bx
"}
(12,1,1) = {"
aa
aC
aG
ay
aS
aG
aM
aT
aV
bb
aG
XP
bm
bk
bk
bk
bm
at
bs
br
bk
bm
aE
aG
"}
(13,1,1) = {"
aa
aa
aG
aG
be
aE
aG
aG
aG
be
aE
aG
aG
aG
aG
aG
aG
aG
be
aG
aG
aG
aG
aa
"}
