//MAP CONVERTED BY dmm2tgm.py THIS HEADER COMMENT PREVENTS RECONVERSION, DO NOT REMOVE
"aa" = (
/turf/space,
/area/space)
"ac" = (
/obj/structure/window/full/shuttle,
/obj/structure/grille,
/turf/simulated/floor/plating,
/area/shuttle/escape)
"ae" = (
/obj/structure/table/wood/fancy/blue,
/obj/item/paper_bin,
/obj/item/pen,
/turf/simulated/floor/carpet/royalblack,
/area/shuttle/escape)
"af" = (
/obj/structure/table/wood/fancy/blue,
/obj/item/folder/red,
/obj/item/restraints/handcuffs,
/obj/item/flash,
/turf/simulated/floor/carpet/royalblack,
/area/shuttle/escape)
"ag" = (
/obj/machinery/computer/robotics,
/turf/simulated/floor/carpet/royalblack,
/area/shuttle/escape)
"ah" = (
/obj/machinery/computer/crew,
/turf/simulated/floor/carpet/royalblack,
/area/shuttle/escape)
"ai" = (
/obj/machinery/computer/emergency_shuttle,
/turf/simulated/floor/carpet/royalblack,
/area/shuttle/escape)
"aj" = (
/obj/machinery/computer/communications,
/turf/simulated/floor/carpet/royalblack,
/area/shuttle/escape)
"ak" = (
/obj/structure/table/wood/fancy/blue,
/obj/item/storage/fancy/donut_box,
/turf/simulated/floor/carpet/royalblack,
/area/shuttle/escape)
"al" = (
/obj/structure/table/wood/fancy/blue,
/obj/machinery/cell_charger,
/obj/item/stock_parts/cell/high,
/turf/simulated/floor/carpet/royalblack,
/area/shuttle/escape)
"am" = (
/obj/structure/table/wood/fancy/blue,
/obj/machinery/recharger,
/obj/structure/extinguisher_cabinet/directional/west,
/turf/simulated/floor/carpet/royalblack,
/area/shuttle/escape)
"an" = (
/turf/simulated/floor/carpet/royalblack,
/area/shuttle/escape)
"ao" = (
/obj/structure/chair/comfy/shuttle{
	dir = 1
	},
/turf/simulated/floor/carpet/royalblack,
/area/shuttle/escape)
"ap" = (
/obj/structure/table/wood/fancy/blue,
/obj/item/storage/toolbox/mechanical,
/obj/structure/extinguisher_cabinet/directional/east,
/turf/simulated/floor/carpet/royalblack,
/area/shuttle/escape)
"ar" = (
/obj/machinery/computer/security{
	network = list("SS13","Research Outpost","Mining Outpost","Telecomms")
	},
/obj/structure/sign/poster/official/nanotrasen_logo{
	pixel_x = -32
	},
/turf/simulated/floor/carpet/royalblack,
/area/shuttle/escape)
"as" = (
/obj/structure/chair/comfy/shuttle{
	dir = 8
	},
/turf/simulated/floor/carpet/royalblack,
/area/shuttle/escape)
"au" = (
/obj/structure/chair/comfy/shuttle{
	dir = 4
	},
/turf/simulated/floor/carpet/royalblack,
/area/shuttle/escape)
"ax" = (
/obj/machinery/computer/station_alert,
/obj/structure/sign/poster/official/nanotrasen_logo{
	pixel_x = 32
	},
/turf/simulated/floor/carpet/royalblack,
/area/shuttle/escape)
"ay" = (
/obj/machinery/computer/secure_data,
/turf/simulated/floor/carpet/royalblack,
/area/shuttle/escape)
"aA" = (
/obj/structure/chair/comfy/shuttle{
	dir = 8
	},
/obj/machinery/light,
/turf/simulated/floor/carpet/royalblack,
/area/shuttle/escape)
"aB" = (
/obj/structure/chair/comfy/shuttle{
	dir = 4
	},
/obj/item/radio/intercom/directional/south,
/obj/machinery/light,
/turf/simulated/floor/carpet/royalblack,
/area/shuttle/escape)
"aC" = (
/obj/machinery/computer/atmos_alert,
/turf/simulated/floor/carpet/royalblack,
/area/shuttle/escape)
"aE" = (
/obj/machinery/door/airlock/command/glass{
	name = "Escape Shuttle Cockpit";
	normalspeed = 0;
	req_access = list(19)
	},
/turf/simulated/floor/carpet/royalblack,
/area/shuttle/escape)
"aF" = (
/obj/structure/chair/comfy/shuttle{
	dir = 8
	},
/turf/simulated/floor/carpet/cyan,
/area/shuttle/escape)
"aG" = (
/obj/machinery/recharger/wallcharger{
	pixel_x = 32
	},
/turf/simulated/floor/shuttle/objective_check{
	icon = 'icons/turf/floors.dmi';
	icon_state = "darkreddarkfull"
	},
/area/shuttle/escape)
"aI" = (
/obj/machinery/door/airlock/medical/glass{
	name = "Escape Shuttle Infirmary"
	},
/turf/simulated/floor/carpet/cyan,
/area/shuttle/escape)
"aJ" = (
/obj/structure/table/reinforced,
/obj/item/storage/fancy/donut_box,
/obj/item/restraints/handcuffs,
/obj/machinery/light{
	dir = 1
	},
/turf/simulated/floor/shuttle/objective_check{
	icon = 'icons/turf/floors.dmi';
	icon_state = "darkreddarkfull"
	},
/area/shuttle/escape)
"aL" = (
/obj/machinery/door/airlock/medical/glass{
	name = "Escape Shuttle Infirmary";
	normalspeed = 0;
	req_access = list(5)
	},
/turf/simulated/floor/carpet/cyan,
/area/shuttle/escape)
"aM" = (
/obj/structure/chair/comfy/shuttle{
	dir = 4
	},
/turf/simulated/floor/carpet/cyan,
/area/shuttle/escape)
"aN" = (
/obj/structure/chair/comfy/shuttle{
	dir = 8
	},
/obj/machinery/light{
	dir = 1
	},
/turf/simulated/floor/carpet/cyan,
/area/shuttle/escape)
"aO" = (
/turf/simulated/floor/glass/reinforced,
/area/shuttle/escape)
"aR" = (
/obj/structure/chair/comfy/shuttle{
	dir = 1
	},
/turf/simulated/floor/shuttle/objective_check{
	icon = 'icons/turf/floors.dmi';
	icon_state = "darkreddarkfull"
	},
/area/shuttle/escape)
"aS" = (
/obj/structure/table/abductor,
/obj/item/reagent_containers/food/snacks/vulpix/chilli,
/turf/simulated/floor/plasteel/dark,
/area/shuttle/escape)
"aU" = (
/obj/structure/chair/stool/bar/dark{
	dir = 4
	},
/turf/simulated/floor/glass/reinforced,
/area/shuttle/escape)
"aV" = (
/obj/structure/table/abductor,
/turf/simulated/floor/plasteel/dark,
/area/shuttle/escape)
"aW" = (
/obj/machinery/door/airlock/security/glass{
	name = "Escape Shuttle Brig";
	normalspeed = 0;
	req_access = list(63)
	},
/turf/simulated/floor/shuttle/objective_check{
	icon = 'icons/turf/floors.dmi';
	icon_state = "darkreddarkfull"
	},
/area/shuttle/escape)
"aX" = (
/obj/structure/chair/comfy/shuttle{
	dir = 8
	},
/obj/machinery/light{
	dir = 1
	},
/turf/simulated/floor/shuttle/objective_check{
	icon = 'icons/turf/floors.dmi';
	icon_state = "darkreddarkfull"
	},
/area/shuttle/escape)
"ba" = (
/turf/simulated/floor/plasteel{
	icon_state = "neutralfull"
	},
/area/shuttle/escape)
"bb" = (
/obj/structure/sign/medbay/greencross,
/turf/simulated/wall/shuttle/onlyselfsmooth,
/area/shuttle/escape)
"bc" = (
/obj/machinery/optable,
/obj/machinery/shower,
/turf/simulated/floor/carpet/cyan,
/area/shuttle/escape)
"bd" = (
/obj/item/storage/box/drinkingglasses,
/obj/item/reagent_containers/food/drinks/shaker,
/obj/structure/table/abductor,
/turf/simulated/floor/plasteel/dark,
/area/shuttle/escape)
"be" = (
/obj/machinery/chem_dispenser/beer,
/obj/structure/table/abductor,
/turf/simulated/floor/plasteel/dark,
/area/shuttle/escape)
"bf" = (
/obj/structure/table/reinforced,
/obj/item/storage/firstaid/o2{
	pixel_x = -3;
	pixel_y = -3
	},
/obj/item/storage/firstaid/regular,
/obj/item/storage/firstaid/toxin{
	pixel_x = 5;
	pixel_y = 5
	},
/turf/simulated/floor/carpet/cyan,
/area/shuttle/escape)
"bg" = (
/obj/structure/chair/comfy/shuttle{
	dir = 1
	},
/obj/machinery/light,
/turf/simulated/floor/shuttle/objective_check{
	icon = 'icons/turf/floors.dmi';
	icon_state = "darkreddarkfull"
	},
/area/shuttle/escape)
"bh" = (
/obj/machinery/recharger/wallcharger{
	pixel_x = 5;
	pixel_y = -28
	},
/turf/simulated/floor/carpet/royalblack,
/area/shuttle/escape)
"bi" = (
/obj/machinery/chem_dispenser/soda,
/obj/structure/table/abductor,
/turf/simulated/floor/plasteel/dark,
/area/shuttle/escape)
"bj" = (
/obj/machinery/door/airlock/security/glass{
	name = "Escape Shuttle Cell";
	normalspeed = 0;
	req_access = list(63)
	},
/turf/simulated/floor/shuttle/objective_check{
	icon = 'icons/turf/floors.dmi';
	icon_state = "darkreddarkfull"
	},
/area/shuttle/escape)
"bk" = (
/obj/machinery/door/airlock/mining/glass{
	name = "Escape Shuttle Cargo";
	normalspeed = 0;
	req_access = list(50)
	},
/turf/simulated/floor/plasteel{
	icon_state = "neutralfull"
	},
/area/shuttle/escape)
"bl" = (
/obj/structure/chair/comfy/shuttle{
	dir = 4
	},
/turf/simulated/floor/shuttle/objective_check{
	icon = 'icons/turf/floors.dmi';
	icon_state = "darkreddarkfull"
	},
/area/shuttle/escape)
"bm" = (
/obj/machinery/sleeper/upgraded{
	dir = 2
	},
/turf/simulated/floor/carpet/cyan,
/area/shuttle/escape)
"bn" = (
/obj/structure/table/reinforced,
/turf/simulated/floor/carpet/orange,
/area/shuttle/escape)
"bo" = (
/obj/machinery/door/airlock/shuttle{
	aiControlDisabled = 1;
	hackProof = 1;
	id_tag = "s_docking_airlock";
	name = "Shuttle Hatch"
	},
/turf/simulated/floor/shuttle/objective_check{
	icon = 'icons/turf/floors.dmi';
	icon_state = "darkredcorners"
	},
/area/shuttle/escape)
"br" = (
/obj/structure/chair/comfy/shuttle{
	dir = 1
	},
/turf/simulated/floor/carpet/orange,
/area/shuttle/escape)
"bu" = (
/obj/structure/shuttle/engine/heater,
/obj/structure/window/reinforced{
	dir = 1
	},
/turf/simulated/floor/shuttle/plating,
/area/shuttle/escape)
"bw" = (
/obj/structure/shuttle/engine/propulsion,
/turf/simulated/floor/shuttle/plating,
/area/shuttle/escape)
"by" = (
/obj/structure/chair/comfy/shuttle{
	dir = 4
	},
/turf/simulated/floor/carpet/orange,
/area/shuttle/escape)
"bz" = (
/turf/simulated/floor/carpet/orange,
/area/shuttle/escape)
"bA" = (
/obj/structure/chair/comfy/shuttle{
	dir = 8
	},
/turf/simulated/floor/carpet/orange,
/area/shuttle/escape)
"bB" = (
/obj/structure/table/reinforced,
/turf/simulated/floor/carpet/purple,
/area/shuttle/escape)
"bC" = (
/obj/structure/sign/directions/engineering,
/turf/simulated/wall/shuttle/onlyselfsmooth,
/area/shuttle/escape)
"bD" = (
/obj/docking_port/mobile/emergency{
	dwidth = 11;
	height = 18;
	timid = 1;
	width = 29;
	port_direction = 8
	},
/obj/machinery/door/airlock/shuttle{
	aiControlDisabled = 1;
	hackProof = 1;
	id_tag = "s_docking_airlock";
	name = "Shuttle Hatch"
	},
/turf/simulated/floor/plasteel/dark,
/area/shuttle/escape)
"bE" = (
/obj/structure/chair/comfy/shuttle{
	dir = 1
	},
/turf/simulated/floor/carpet/purple,
/area/shuttle/escape)
"bG" = (
/obj/machinery/status_display,
/turf/simulated/wall/shuttle,
/area/shuttle/escape)
"bH" = (
/obj/structure/chair/comfy/shuttle{
	dir = 4
	},
/obj/structure/extinguisher_cabinet/directional/west,
/turf/simulated/floor/shuttle/objective_check{
	icon = 'icons/turf/floors.dmi';
	icon_state = "darkreddarkfull"
	},
/area/shuttle/escape)
"bI" = (
/obj/structure/chair/comfy/shuttle{
	dir = 4
	},
/turf/simulated/floor/carpet/purple,
/area/shuttle/escape)
"bJ" = (
/turf/simulated/floor/carpet/purple,
/area/shuttle/escape)
"bK" = (
/obj/structure/chair/comfy/shuttle{
	dir = 8
	},
/turf/simulated/floor/carpet/purple,
/area/shuttle/escape)
"bL" = (
/obj/structure/chair/comfy/shuttle{
	dir = 4
	},
/obj/structure/extinguisher_cabinet/directional/west,
/obj/machinery/light{
	dir = 8
	},
/turf/simulated/floor/carpet/orange,
/area/shuttle/escape)
"bM" = (
/obj/structure/chair/comfy/shuttle{
	dir = 8
	},
/obj/structure/extinguisher_cabinet/directional/east,
/turf/simulated/floor/carpet/purple,
/area/shuttle/escape)
"bO" = (
/obj/structure/chair/comfy/shuttle{
	dir = 4
	},
/obj/machinery/light{
	dir = 8
	},
/turf/simulated/floor/plasteel{
	dir = 1;
	icon_state = "bot"
	},
/area/shuttle/escape)
"bP" = (
/obj/structure/chair/comfy/shuttle{
	dir = 4
	},
/turf/simulated/floor/plasteel{
	dir = 1;
	icon_state = "bot"
	},
/area/shuttle/escape)
"bQ" = (
/obj/structure/chair/comfy/shuttle{
	dir = 8
	},
/turf/simulated/floor/plasteel{
	dir = 1;
	icon_state = "bot"
	},
/area/shuttle/escape)
"bR" = (
/obj/structure/flora/ausbushes/grassybush,
/obj/structure/flora/ausbushes/lavendergrass,
/obj/structure/flora/ausbushes/ppflowers,
/obj/structure/flora/ausbushes/sunnybush,
/obj/structure/window/full/shuttle,
/turf/simulated/floor/grass,
/area/shuttle/escape)
"bS" = (
/obj/structure/chair/comfy/shuttle{
	dir = 4
	},
/obj/structure/extinguisher_cabinet/directional/west,
/obj/machinery/light{
	dir = 8
	},
/turf/simulated/floor/carpet/purple,
/area/shuttle/escape)
"bT" = (
/obj/machinery/door/airlock/shuttle{
	aiControlDisabled = 1;
	hackProof = 1;
	id_tag = "s_docking_airlock";
	name = "Shuttle Hatch"
	},
/turf/simulated/floor/plasteel/dark,
/area/shuttle/escape)
"bU" = (
/obj/structure/sign/directions/science,
/turf/simulated/wall/shuttle/onlyselfsmooth,
/area/shuttle/escape)
"bV" = (
/obj/structure/sign/directions/cargo,
/turf/simulated/wall/shuttle/onlyselfsmooth,
/area/shuttle/escape)
"bW" = (
/obj/structure/chair/comfy/shuttle{
	dir = 4
	},
/obj/machinery/recharger/wallcharger{
	pixel_x = -24
	},
/turf/simulated/floor/shuttle/objective_check{
	icon = 'icons/turf/floors.dmi';
	icon_state = "darkreddarkfull"
	},
/area/shuttle/escape)
"bX" = (
/obj/machinery/ai_status_display,
/turf/simulated/wall/shuttle/onlyselfsmooth,
/area/shuttle/escape)
"bY" = (
/obj/structure/flora/ausbushes/grassybush,
/obj/structure/flora/ausbushes/lavendergrass,
/obj/structure/flora/ausbushes/ywflowers,
/obj/structure/flora/ausbushes/fernybush,
/obj/structure/window/full/shuttle,
/turf/simulated/floor/grass,
/area/shuttle/escape)
"bZ" = (
/obj/machinery/recharge_station/upgraded,
/turf/simulated/floor/plasteel{
	icon_state = "neutralfull"
	},
/area/shuttle/escape)
"ca" = (
/obj/machinery/light,
/turf/simulated/floor/plasteel{
	icon_state = "neutralfull"
	},
/area/shuttle/escape)
"cb" = (
/obj/machinery/door/airlock/engineering/glass{
	name = "Escape Shuttle Engineering";
	normalspeed = 0;
	req_access = list(32)
	},
/turf/simulated/floor/carpet/orange,
/area/shuttle/escape)
"cd" = (
/obj/machinery/door/airlock/research/glass{
	name = "Escape Shuttle Research";
	normalspeed = 0;
	req_access = list(47)
	},
/turf/simulated/floor/carpet/purple,
/area/shuttle/escape)
"ck" = (
/obj/structure/chair/comfy/shuttle{
	dir = 8
	},
/obj/structure/extinguisher_cabinet/directional/east,
/turf/simulated/floor/plasteel{
	dir = 1;
	icon_state = "bot"
	},
/area/shuttle/escape)
"cp" = (
/turf/simulated/floor/carpet/cyan,
/area/shuttle/escape)
"cw" = (
/obj/structure/bed/roller,
/obj/machinery/iv_drip,
/turf/simulated/floor/carpet/cyan,
/area/shuttle/escape)
"cA" = (
/obj/structure/chair/comfy/shuttle{
	dir = 4
	},
/obj/machinery/light{
	dir = 8
	},
/turf/simulated/floor/carpet/purple,
/area/shuttle/escape)
"cD" = (
/obj/structure/table/reinforced,
/obj/item/storage/backpack/medic,
/obj/item/storage/belt/medical,
/turf/simulated/floor/carpet/cyan,
/area/shuttle/escape)
"cE" = (
/obj/structure/bed/roller,
/obj/machinery/light{
	dir = 1
	},
/turf/simulated/floor/carpet/cyan,
/area/shuttle/escape)
"cG" = (
/obj/structure/table/reinforced,
/obj/item/clothing/gloves/color/latex/nitrile,
/obj/item/clothing/mask/breath,
/turf/simulated/floor/carpet/cyan,
/area/shuttle/escape)
"cH" = (
/turf/simulated/wall/shuttle,
/area/shuttle/escape)
"db" = (
/obj/structure/chair/stool/bar/dark{
	dir = 1
	},
/turf/simulated/floor/glass/reinforced,
/area/shuttle/escape)
"gi" = (
/obj/structure/extinguisher_cabinet/directional/west,
/turf/simulated/floor/carpet/cyan,
/area/shuttle/escape)
"kR" = (
/turf/simulated/wall/shuttle/nodiagonal,
/area/shuttle/escape)
"mM" = (
/obj/structure/chair/comfy/shuttle{
	dir = 8
	},
/turf/simulated/floor/shuttle/objective_check{
	icon = 'icons/turf/floors.dmi';
	icon_state = "darkreddarkfull"
	},
/area/shuttle/escape)
"pp" = (
/obj/machinery/door/airlock/external,
/obj/structure/fans/tiny,
/turf/simulated/floor/plating,
/area/shuttle/escape)
"qS" = (
/obj/structure/sign/directions/security{
	dir = 1
	},
/turf/simulated/wall/shuttle/onlyselfsmooth,
/area/shuttle/escape)
"sc" = (
/obj/machinery/door/airlock/medical/glass{
	name = "Escape Shuttle Medical Seating";
	normalspeed = 0;
	req_access = list(5)
	},
/turf/simulated/floor/carpet/cyan,
/area/shuttle/escape)
"un" = (
/obj/structure/extinguisher_cabinet/directional/north,
/turf/simulated/floor/plasteel{
	icon_state = "neutralfull"
	},
/area/shuttle/escape)
"xD" = (
/obj/structure/table/reinforced,
/obj/item/reagent_containers/iv_bag/bloodsynthetic/oxygenis,
/obj/item/reagent_containers/iv_bag/bloodsynthetic/oxygenis,
/obj/item/reagent_containers/iv_bag/bloodsynthetic/oxygenis,
/obj/item/reagent_containers/iv_bag/bloodsynthetic/oxygenis,
/obj/item/reagent_containers/iv_bag/bloodsynthetic/oxygenis,
/obj/item/reagent_containers/iv_bag/bloodsynthetic/oxygenis,
/obj/machinery/light,
/turf/simulated/floor/carpet/cyan,
/area/shuttle/escape)
"yW" = (
/obj/machinery/light{
	dir = 1
	},
/turf/simulated/floor/plasteel{
	icon_state = "neutralfull"
	},
/area/shuttle/escape)
"zJ" = (
/obj/structure/chair/comfy/shuttle{
	dir = 4
	},
/obj/structure/extinguisher_cabinet/directional/west,
/turf/simulated/floor/carpet/cyan,
/area/shuttle/escape)
"Ag" = (
/obj/structure/chair/comfy/shuttle{
	dir = 8
	},
/obj/machinery/light{
	dir = 4
	},
/turf/simulated/floor/plasteel{
	dir = 1;
	icon_state = "bot"
	},
/area/shuttle/escape)
"Am" = (
/obj/structure/chair/comfy/shuttle{
	dir = 4
	},
/obj/machinery/light{
	dir = 8
	},
/turf/simulated/floor/carpet/orange,
/area/shuttle/escape)
"CE" = (
/obj/structure/table/abductor,
/obj/item/reagent_containers/food/snacks/vulpix/cheese,
/turf/simulated/floor/plasteel/dark,
/area/shuttle/escape)
"GC" = (
/turf/simulated/floor/shuttle/objective_check{
	icon = 'icons/turf/floors.dmi';
	icon_state = "darkreddarkfull"
	},
/area/shuttle/escape)
"IB" = (
/obj/machinery/status_display,
/turf/simulated/wall/shuttle/onlyselfsmooth,
/area/shuttle/escape)
"La" = (
/obj/structure/sign/directions/medical{
	dir = 1
	},
/turf/simulated/wall/shuttle/onlyselfsmooth,
/area/shuttle/escape)
"LE" = (
/obj/machinery/bodyscanner{
	dir = 2
	},
/turf/simulated/floor/carpet/cyan,
/area/shuttle/escape)
"PY" = (
/obj/structure/table/reinforced,
/obj/item/storage/firstaid/machine{
	pixel_x = -5;
	pixel_y = -5
	},
/obj/item/storage/firstaid/regular,
/obj/item/storage/firstaid/adv{
	pixel_x = 5;
	pixel_y = 5
	},
/turf/simulated/floor/carpet/cyan,
/area/shuttle/escape)
"Qf" = (
/obj/machinery/defibrillator_mount/loaded{
	pixel_y = -4
	},
/turf/simulated/wall/shuttle/onlyselfsmooth,
/area/shuttle/escape)
"Rq" = (
/obj/structure/table/abductor,
/obj/item/reagent_containers/food/snacks/vulpix/bacon,
/turf/simulated/floor/plasteel/dark,
/area/shuttle/escape)
"RT" = (
/obj/effect/spawner/window/shuttle,
/turf/simulated/floor/plating,
/area/shuttle/escape)
"TX" = (
/turf/simulated/wall/shuttle/onlyselfsmooth/nodiagonal,
/area/shuttle/escape)
"VF" = (
/turf/simulated/wall/shuttle/onlyselfsmooth,
/area/shuttle/escape)
"Wy" = (
/obj/structure/chair/comfy/shuttle,
/turf/simulated/floor/shuttle/objective_check{
	icon = 'icons/turf/floors.dmi';
	icon_state = "darkreddarkfull"
	},
/area/shuttle/escape)

(1,1,1) = {"
aa
cH
VF
RT
VF
VF
cH
cH
VF
bo
VF
bD
VF
RT
RT
RT
cH
bT
cH
bT
VF
VF
RT
RT
VF
cH
cH
cH
aa
"}
(2,1,1) = {"
aa
VF
bl
bl
bH
RT
bl
bW
bH
GC
cH
ba
bP
bP
bP
bP
bP
ba
ba
ba
bR
bP
bP
bP
bO
bP
cH
cH
cH
"}
(3,1,1) = {"
aa
RT
GC
GC
GC
bj
GC
GC
GC
GC
cH
ba
ba
ba
ba
ba
ba
ba
ba
ca
bV
ba
ba
ba
ba
ba
RT
bu
bw
"}
(4,1,1) = {"
aa
VF
aX
mM
mM
RT
GC
GC
GC
aR
cH
ba
bQ
bQ
bQ
bQ
bQ
bQ
ba
ba
bk
ba
ba
ba
ba
ba
RT
bu
bw
"}
(5,1,1) = {"
cH
cH
cH
cH
cH
kR
Wy
GC
GC
bg
qS
yW
bP
bP
bP
bP
bP
bP
ba
ba
bR
bQ
ck
bQ
Ag
bQ
cH
cH
cH
"}
(6,1,1) = {"
VF
ae
am
ar
ay
bG
aJ
GC
GC
GC
aW
ba
ba
ba
ba
ba
ba
ba
ba
ba
IB
bY
VF
bR
bX
bY
VF
cH
cH
"}
(7,1,1) = {"
RT
af
an
as
aA
cH
Wy
aG
GC
GC
aW
ba
bQ
bQ
bQ
bQ
bQ
bQ
ba
ba
bR
bI
bS
bI
cA
bB
cH
cH
cH
"}
(8,1,1) = {"
RT
ag
ao
an
bh
kR
cH
VF
aW
ac
VF
yW
bP
bP
bP
bP
bP
bP
ba
ca
bU
bJ
bJ
bJ
bJ
bE
RT
bu
bw
"}
(9,1,1) = {"
RT
ah
ao
an
an
aE
an
an
an
an
aE
ba
ba
ba
ba
ba
ba
ba
ba
ba
cd
bJ
bJ
bJ
bJ
bE
RT
bu
bw
"}
(10,1,1) = {"
RT
ai
ao
an
an
aE
an
an
an
an
aE
ba
ba
ba
ba
ba
ba
ba
ba
ba
bR
bJ
bJ
bJ
bJ
bE
RT
bu
bw
"}
(11,1,1) = {"
RT
aj
ao
an
an
kR
cH
VF
aL
ac
bb
yW
bQ
bQ
bQ
bQ
bQ
bQ
ba
ba
bR
bK
bM
bK
bK
bB
RT
bu
bw
"}
(12,1,1) = {"
RT
ak
an
au
aB
cH
bm
gi
cp
cp
aI
ba
bP
bP
bP
bP
bP
bP
ba
ba
IB
bY
VF
bR
bX
bY
kR
cH
cH
"}
(13,1,1) = {"
VF
al
ap
ax
aC
bG
LE
cp
cp
cp
aI
ba
ba
ba
ba
ba
ba
ba
ba
ba
bR
by
bL
by
Am
bn
cH
cH
cH
"}
(14,1,1) = {"
cH
cH
cH
cH
cH
cH
bc
cp
cp
cw
La
yW
ba
aU
aU
aU
aU
aO
ba
ca
bC
bz
bz
bz
bz
br
cH
cH
cH
"}
(15,1,1) = {"
aa
VF
aM
aM
zJ
Qf
cE
cp
cp
cw
cH
un
ba
aV
CE
Rq
aV
db
ba
ba
cb
bz
bz
bz
bz
br
RT
bu
bw
"}
(16,1,1) = {"
aa
RT
cp
cp
cp
sc
cp
cp
cp
xD
cH
ba
ba
ba
ba
ba
aS
db
ba
ba
bR
bz
bz
bz
bz
br
RT
bu
bw
"}
(17,1,1) = {"
aa
VF
aN
aF
aF
VF
cG
PY
cD
bf
cH
ba
ba
bd
be
bi
aV
db
bZ
bZ
bR
bA
bA
bz
bz
bn
cH
cH
cH
"}
(18,1,1) = {"
aa
cH
VF
RT
VF
cH
cH
cH
cH
cH
kR
RT
RT
RT
RT
RT
RT
VF
RT
RT
TX
RT
RT
pp
pp
RT
kR
cH
aa
"}
